Module 3 – Free Time
Les ordinateurs et les portables	Computers and mobile phones
Qu’est-ce que tu fais … 	What do you do/are you doing …
avec ton ordinateur?	on your computer?
avec ton portable?	on your mobile phone?
Je joue.	I play/I’m playing games.
Je surfe sur Internet.	I surf/I’m surfing the net.
Je tchatte sur MSN.	I chat/I’m chatting on MSN.
Je regarde des clips vidéo.	I watch/I’m watching video clips.
Je télécharge de la musique.	I download/I’m downloading music.
J’envoie des SMS.	I text/I’m texting.
Je parle avec mes ami(e)s/mes copains/mes copines.	I talk/I’m talking to my friends/mates.
J’envoie des e-mails.	I send/I’m sending e-mails.
	
La fréquence	Frequency
quelquefois	sometimes
souvent	often
tous les jours	every day
tous les soirs	every evening
tout le temps	all the time
de temps en temps	from time to time
une fois par semaine	once a week
deux fois par semaine	twice a week
	
Le sport	Sport
Je joue …	I play …
au basket	basketball
au billard	billiards/snooker
au foot(ball)	football
au hockey	hockey
au rugby	rugby
au tennis	tennis
au tennis de table/au ping-pong	table tennis
au volleyball	volleyball
à la pétanque/aux boules	boules
sur la wii	on the wii
Tu es sportif/sportive?	Are you sporty?
Je suis (assez) sportif/sportive.	I’m (quite) sporty.
Je ne suis pas (très) sportif/sportive.	I’m not (very) sporty.
Mon sportif/Ma sportive préféré(e) est	My favourite sportsman/sportswoman 
	
Qu’est-ce que tu fais?	What do you do?
Je fais du judo.	I do judo.
Je fais du parkour.	I do parkour.
Je fais du patin à glace.	I go ice-skating.
Je fais du roller.	I go roller-skating.
Je fais du skate.	I go skateboarding.
Je fais du vélo.	I go cycling.
Je fais de la danse.	I do dance.
Je fais de la gymnastique	I do gymnastics.
Je fais de la natation.	I go swimming.
Je fais de l’équitation.	I go horse-riding.
Je fais des promenades.	I go for walks.
	
Quand?	When?
en été	in summer
en hiver	in winter
quand il fait beau	when it’s good weather
quand il fait chaud	when it’s hot
quand il pleut	when it rains
quand il fait froid	when it’s cold
	
Qu’est-ce que tu aimes faire?	What do you like doing?
le soir/le weekend	in the evenings/at the weekends
le samedi matin/après-midi/soir	on Saturday mornings/afternoons/evenings
J’aime …	I like …
… retrouver mes amis en ville.	… meeting my friends in town.
… regarder la télévision (la télé).	… watching TV.
… jouer sur ma PlayStation.	… playing on my PlayStation.
… écouter de la musique.	… listening to music.
… faire les magasins.	… going shopping.
… faire du sport.	… doing sport.
… jouer au football.	… playing football.
… traîner avec mes copains.	… hanging out with my mates.
… téléphoner à mes copines.	… phoning my mates.
	
Qu’est-ce qu’ils font?	What do they do?
Il fait de la lutte.	He does wrestling.
Elle fait du jogging.	She goes jogging.
Elle a gagné le match.	She won the match.
Il est champion régional.	He’s the regional champion.
Elle s’entraîne (trois) fois par semaine.	She trains (three) times a week.
Ils font de la musculation.	They do weight training.
Elles écoutent de la musique.	They listen to music.
Ils jouent au foot.	They play football.
Elles regardent la télé.	They watch TV.
Ils sont des clowns.	They’re clowns.
Elles aiment le R&B.	They like R&B.
	
Les mots essentiels	High-frequency words
sur	on
en (été)	in (summer)
quand	when
tout/toute/tous/toutes	all
par (deux fois par semaine)	per (twice a week)
d’habitude	usually
d’abord	first of all
ensuite	then/next
puis	then/next